16 16
2
4
8
2 13
0; 0; 0; 0; 0; 0; 4; 0; 0; 0; 0; 0; 0; 0; 0; 0
0; 0; 0; 0; 0; 0; 4; 4; 4; 4; 4; 0; 4; 0; 4; 0
0; 0; 0; 0; 0; 0; 4; 4; 4; 4; 4; 4; 4; 4; 4; 4
0; 0; 0; 0; 0; 0; 4; 4; 4; 4; 4; 4; 4; 4; 4; 0
0; 0; 0; 0; 0; 0; 7M; 4; 7; 7; 4; 4; 4; 4; 4M; 0
0; 0; 0; 0; 0; 0; 7; 7; 0; 7; 4; 4; 0; 4; 4P; 0
0; 0; 0; 0; 0; 0; 7; 7; 3; 4; 4; 0; 4; 4; 0; 1
0; 0; 0; 6; 6; 7; 7; 7; 7; 0; 0; 0; 0; 0; 1; 0
0; 0; 6; 0; 7; 7; 7; 7; 0; 0; 0; 0; 2; 1; 0; 0
0; 6; 6; 6; 0; 7; 7; 7; 0; 0; 0; 0; 2M; 2; 1; 0
0; 0; 6; 7; 7; 7; 7; 7; 7; 0; 2; 0; 2; 2; 1; 0
0; 0; 0; 6; 7; 7; 7; 7; 2; 2; 2P; 2; 2; 2; 2P; 0
6; 6; 6; 7; 7; 7; 7; 7; 0; 0; 0; 2; 2; 2; 2; 0
0; 0; 0; 6; 7M; 7; 0; 0; 5; 5M; 2M; 2; 0; 0; 0; 0
0; 0; 0; 7; 0; 0; 5; 5; 0; 2; 2M; 2M; 0; 0; 0; 0
0; 0; 0; 0; 0; 0; 5; 0; 2; 2; 2; 2; 0; 0; 0; 0
