16 16
2
4
8
8 7
0; 0; 3; 3; 0; 0; 0; 0; 3; 0; 0; 0; 0; 0; 0; 0
0; 0; 0; 3; 3; 3; 0; 0; 3; 6; 6; 0; 0; 0; 0; 0
0; 0; 0; 0; 3; 3; 0; 3; 3; 6; 6; 6; 0; 0; 0; 0
0; 0; 0; 3; 3M; 3; 3M; 0; 3; 3; 6; 6; 6; 7; 6; 0
0; 0; 3; 3; 3; 1; 3; 3; 3; 3; 3; 6; 6; 6; 7; 0
0; 1; 1; 1; 1; 3; 1; 1; 3; 3; 3; 0; 6; 6; 7; 0
4; 0; 1; 1; 1; 1; 1; 0; 0; 7; 7; 7P; 7; 0; 7; 7
0; 4; 0; 1; 1; 1M; 0; 7; 0; 7P; 7; 0; 7; 7; 0; 0
0; 4; 1; 0; 0; 1; 1; 1; 7; 7; 0; 7; 7; 7; 7; 0
0; 4; 4; 0; 0; 1; 1; 1; 0; 1; 7; 7; 7; 7; 7M; 0
4; 0; 4; 4; 4; 4; 1; 0; 1; 1; 7; 2; 7; 7; 0; 0
0; 4; 4; 4; 4; 4; 4; 4; 1; 4; 2; 2; 7; 2; 0; 0
4; 4; 4; 4; 4; 4; 4; 4; 4; 4; 4; 2; 2; 2; 2; 2
4; 4; 4; 4; 4; 4; 4; 4; 4; 4; 0; 5; 2; 2M; 2M; 0
0; 4; 0; 4; 0; 0; 4M; 4; 4; 4M; 4; 5P; 5; 2M; 5; 0
0; 0; 0; 0; 0; 0; 0; 0; 4; 4; 0; 0; 0; 5M; 0; 0
