16 16
3
6
8
7 2
3; 0; 0; 0; 0; 3; 0; 3; 0; 0; 0; 0; 0; 0; 0; 0; 
0; 3; 3; 3; 3; 3; 3; 3; 3; 0; 0; 5; 0; 5; 5; 0; 
0; 3; 0; 3; 3; 3; 3; 3; 3; 3; 3; 3; 5; 5; 5; 0; 
0; 0; 3; 3; 3; 3; 3; 3; 3; 3; 3; 5; 5; 5; 5; 5; 
0; 0; 3; 3; 3; 3; 3; 3; 3; 3; 3; 5; 5; 5; 5; 0; 
0; 3; 3; 3; 3; 3; 3; 3; 3; 1; 1; 1; 5; 5; 5; 5; 
0; 3; 3; 3; 3; 3; 3; 3; 1P; 1; 1; 1; 5; 5; 0; 0; 
3P; 3; 3; 3; 3; 3; 3; 3; 3; 3; 6; 1; 1; 0; 0; 0; 
0; 3; 3; 3; 3; 3; 3; 3; 3; 3; 6; 1; 1; 0; 0; 0; 
0; 3M; 3M; 3; 3; 3; 3; 3; 3; 7; 7; 6; 6; 0; 0; 0; 
0; 3M; 3; 3M; 3; 3; 3; 3; 7; 7; 6; 0; 6; 0; 0; 0; 
0; 0; 3; 3; 3M; 0; 3; 3; 7; 7; 0; 0; 0; 4; 4; 4; 
0; 3; 3; 2; 2P; 0; 0; 0; 7; 7; 0; 0; 4; 4; 4; 0; 
0; 3; 2; 2; 0; 2; 0; 2; 2; 2; 0; 4; 4; 4; 4; 0; 
0; 0; 2; 2; 2; 2; 2; 2; 2; 2; 2; 4; 4; 4; 4; 0; 
0; 0; 0; 2; 0; 2; 2; 0; 2; 0; 0; 4; 4; 4; 0; 0; 
